_ילדה עם שיער מוזר (ילדה עם שיער מוזר) : דיוויד פוסטר וואלאס : אלינוער ברגר : אנגלית
15 שעות : דייוויד קסלר : טל ארצי : אנגלית
52 פיתויים : בטי הרברט : זיו יצחקי : אנגלית
1984 : ג'ורג' אורוול : יהודית אביטל : אנגלית 
אבדות : לאה גולדברג : None : עברית
אבן, נייר : תומר גרדי : None : עברית
אדיוס, המינגוויי (אדיוס, המינגווי) :  ליאונרדו פדורה : טל ניצן : ספרדית
אהבה בימי כולרה : גבריאל גריסה מארקס : ריטה מלצר ואמציה פורת : ספרדית
אהבה בלתי אפשרית : יעל רוזמן : None : עברית
אהבה על החוף : מיכל גוברין : None : עברית
אוטוביוגרפיה : מ. ק. גנדהי : יניץ לוי : אנגלית
און-ליין : מיכל בכר : None : עברית
אוריאן : שירה פנקס : None : עברית
אושר אפשרי : דר טל בן-שחר : עידית שורר : אנגלית
אז ככה : בטיסט בולייה : רמה איילון : צרפתית
אחריות תאגידית : עברי ורבין : None : עברית
אחת עשרה אליפויות : פיל ג'קסון יחד עם יו דלהנטי : תומר שפינדל : אנגלית
איגוד השוטרים היִידים : מייקל שייבון : משה רון : אנגלית
איזון מופלא : לוסיה אצ'ווריה : יערית בן-יעקב : ספרדית
איינשטיין חייו והיקום שלו : וולטר אייזקסון : דוד מדר : אנגלית
איך (איך - זה הכול) : דב סיידמן : תומר שפינדל : אנגלית
אילון מאסק : אשלי ואנס : כנרת היגינס-דוידי : אנגלית
אינטליגנציה אקולוגית : דניאל גולמן : יבודה בן-מוחה : אנגלית
אינטליגנציה חיובית איך תוכלו לממש את מלוא הפוטנציאל שלכם ולזכות בהצלחה מקצועית ובסיפוק אישי (אינטליגנציה חיובית ) : שירזאד צ'אמין : תומר שפינדל : אנגלית
אינטליגנציה תוצאתית היכולת לניהול עצמי ממוקד תוצאות (אינטליגנציה תוצאתית) : דר דיתי קליין : None : עברית
אירבוס A320 : עמנואל בלחסן : None : עברית
איש איטי : ג'. מ. קוטז : אברהם יבין : אנגלית
איש בחושך : פול אוסטר : מיכל אלפון : אנגלית
איש ליד מכונה : סטף ורטהימר : None : עברית
איש ללא שם (עוד מעט החורף מתחיל) : שי אספריל : None : עברית
אישה בשמלה ירוקה : מיה לוי-ירון : None : עברית
אל תיגע בזמיר : נל הרפר לי : צבי ארד : אנגלית
אלו הם מים : דיוויד פוסטר וואלאס : אסף גברון : אנגלית
אלוהים וסקס : מייקל קוגן : יעל סלע-שפירו : אנגלית
אלוהים יודע : ג'וזף הלר : מאיר ויזלטיר : אנגלית
אלוהים מה זה צריך להביע : סיימון ריץ' : טל ארצי : אנגלית
אלי פורש כנפים : נגה אלבלך : None : עברית
אלילית : ג'וזפין אנג'ליני : יעל ענבר : אנגלית
אלימות אלוהית : עדי אופיר : None : עברית
אלף שמשות זוהרות : חאלד חוסייני : צילה אלעזר : אנגלית
אמא של אלף שמונים וארבע : מהשוטה דוי : ניב סבריאגו : אנגלית
אמה ויגואר : אריקה פישר : דפנה עמית : גרמנית
אמנות ההקשבה לפעימות הלב : יאן פיליפ סנדקר : יוסיפיה סימון : אנגלית
אנחנו ושכמותנו : סרגיי דובלטוב : שי מרקוביץ' : רוסית
אני כוכב נולד (הדחיפה) : נגה אלבלך : None : עברית
אני לא זוכרת כלום : נורה אפרון : אורית הראל : אנגלית
אני, הנרי השמיני : מרגרט ג'ורג' : צילה אלעזר : אנגלית
אני, נלסון מנדלה – שיחות עם עצמי (אני, נלסון מנדלה) : נלסון מנדלה : קובי מידן : אנגלית
אנציקלופדיה של הרעיונות  תרבות, מחשבה, תקשורת (אנציקלופדיה של הרעיונות) : דוד גורביץ' : None : עברית
אנשים מעדיפים לטבוע בים : ליאור דיין : None : עברית
אסטרטגיית האוקיינוס הכחול : וו' צ'אן קים, רנה מובורן : עפר קובר : אנגלית
אסיר השמיים (אסיר השמים) : קרלוס רואיס סאפון : מונה גודאר : ספרדית
אסכולה ישנה : טוביאס וולף : משה רום : אנגלית
אסרה : מקסים בילר : מיכאל דק : גרמנית
אפ, סימבה (אקספרס הדיבור הישיר) : דיוויד פוסטר וואלאס : דבי אילון : אנגלית
אפס עד 12 : ארנה קזין : None : עברית
אפשרות של אלימות אברהם אברהם החקירה השניה (אפשרות של אלימות) : דרור משעני : None : עברית
אקספרס הדיבור הישיר : דיוויד פוסטר וואלאס : דבי אילון : אנגלית
ארוחת בוקר ישראלית' (ארוחת בוקר ישראלית) : ויסמן ניצן : None : עברית
ארי ודנטה מגלים את סודות היקום : בנג'מין אלירה סאיינז : מאירה פירון : אנגלית
ארץ אררט : יעל גלר : None : עברית
ארץ הצללים : אליסון נואל : נילי לוי : אנגלית
אש (אש - שבע הממלכות 2) : קריסטין קאשור : יעל אכמון : אנגלית
אשה אחת נפלה : אילון עמית : None : עברית
אשה בשמלה ירוקה : מיה לוי-ירון : None : עברית
אשה זרה : אבירמה גולן : None : עברית
אתם, שחיים יפה כל כך : מיכאל פאר : None : עברית
באושר ובאושר כיצד לחיות חיי סיפוק ושמחה פסיכולוגיה חיובית בחיי היומיום (באושר ובאושר) : דר טח בן שחר : עידית שורר : אנגלית
בבקשה תשגיחי על אמא : קיונג סוק שין : מרב זקס-פורטל : אנגלית
בגידה : כריסטופר רייך : אסנת הדר : אנגלית
בדידות מזהרת : עמיחי שלו : None : עברית
בוא כמו שאתה : רון דהן : None : עברית
בזעיר אנפין : ירמי פינקוס : None : עברית
בחזקת שלושה : יוסי אלפי : None : עברית
בין הרציחות : ארווינד אדיגה : יואב כ"ץ : עברית
בינת השכווי : אביגדור דגן : צבי אדר : אנגלית
בית בודנבורק (בית בודנברוק) : תומאס מאן : נילי מירסקי : גרמנית
בית הממתקים : קארין גרהרדסן : יעל צובארי : אנגלית
בנגאזי (בנגאזי-ברגן-בלזן) : יוסי סוכרי : None : עברית
בנדיט : איתמר אורלב : None : עברית
בנתיב הבטוח : עוד ערן בן עמי : None : עברית
בעל זבוב : ויליאם גולדינג : אמיר צוקרמן : אנגלית
בעקבות שרלמאן : סטיב ברי פרולוג : אורי בלסם : אנגלית
בשם אנגליה : ג'יימס הוז : אסף גברון : אנגלית
בתחבולות תעשה לך עסקים : ישראל לביא : None : עברית
גבולות : רונית רפ : None : עברית
גברת ורבורג : עירית לינור : None : עברית
גוזל : ארנה קזין : None : עברית
גוף זר : ענת גור : None : עברית
גטסבי הגדול : פ' סקוט פיצג'רלד : ליאור שטרנברג : אנגלית
גיים אובר : דנה אבירם : None : עברית
גלי עומק (טרמינל) : אילן גופר : None : עברית
גן העדן : ארנסט המינגווי : יואב כ"ץ : אנגלית
גשם שחור :  גראהם בראון : אמנון כץ : אנגלית
דאעש : צור שיזף : None : עברית
דברי מתיקה : איאן מקיואן : מיכל אלפרון : אנגלית
דודי נפוליאון : איראג` פֶּזֶשְׁכְּזָאד : אורלי נוי : פרסית
דושינקא, נשמה : איריס אליה-כהן : None : עברית
דחיינות : פירז סטיל : עופר שור : אנגלית
איש שלא הבחין בשום דבר : רוברט ואלזר : רן הכהן : גרמנית
אלי פורש כנפיים : נגה אלבלך : None : עברית
דיאטת השלום העולמי : דר וויל טאטל : עדי צור, יונתן בר, רימונה גרסון : אנגלית
דידי שם זמני : עדנה קפלן-הגלר" : None : עברית
דיונות החול של פריז: עדנה שמש : None : עברית
דקה לחצות : יאיר פלקר : None : עברית
האימפרו (האימפרו - כוח המחשבה): שי גור : None : עברית
איטליה, ענן : מרקו לודולי : ארנו בר : איטלקית
בפתח הכרך הרביעי של  הטור השביעי לאלתרמן (הטור השביעי - כרך ד') : נתן אלתרמן : None : עברית
האינטליגנציה הרפואית שלך : ג'רום גרופמן ופמלה הארטצבנד : יעל ענבר : אנגלית
האיש משם : יצחק בן נר : None : עברית
האיש שלנו בהוואנה : גראהם גרין : יואב כ"ץ : אנגלית
האיש שצפה ברכבות : 	ז'ורז' סימנון : יהושע קנז : צרפתית
האישה עם הפנקס האדום : אנטואן לורן : רמה איילון : צרפתית
האצטדיון : עמוס טלשיר : None : עברית
הבדיחה : מילן קונדרה : דב קווסטלר : צ'כית
הבלתי נראים : רוי יקובסן : דנה כספי : נורווגית
הזהו אדם : פרימו לוי : יצחק גרטי : איטלקית
הוכחה לגן עדן מסעו המופלא של מנתח מוח אל העולם הבא (הוכחה לגן עדן) : דר אבן אלכסנדר : צילה אלעזר :אנגלית
הבִקעה : ג'ומפה להירי : מיכל אלפון : אנגלית
הגוף האנושי : פאולו ג'ורדנו : יערית בן-יעקב : איטלקית
הדבר היה ככה : מאיר שליו : None : עברית
הדבר : אלבר קאמי : אילנה המרמן : צרפתית
הדרשה על נפילת רומי : ז'רום פרארי : רמה איילון : צרפתית
ההחלטה : בריטה בוהלר : רחל ליברמן : הולנדית
ההמצאה של מורל : אדולפו ביוי קסארס : ענת דוידי : אנגלית
הזנב הארוך : כריס אנדרסון : דרורה בלישה : אנגלית
החבר שלי, הָאנֶס : ריטה פאלק : דפנה עמית : גרמנית
החייל מס' 2 : פזית בן נון בלום : None : עברית
החיים הוראות שימוש (ז'ורז' פרק , חיים במילים) : דייוויד בלוס : יניב חג'בי : אנגלית
החיים הסודיים של המוח המבוגר : 	ברברה שטראוך : גיא הרלינג : אנגלית
החיים, האהבה, המוות : מישקה בן דוד : None : עברית
החנות שיש בה הכול  ג'ף בזוס ועלייתה של אמזון (החנות שיש בה הכול) : בראד סטון : תומר שפינדל : אנגלית
הטוב, הרע והמכוער באינטרנט  הפסיכולוגיה של החיים ברשת (הטוב, הרע והמכוער באינטרנט) : פרופ יאיר עמיחי-המבורגר : None : עברית
המעון של מיס פרגרין לילדים משונים : רנסום ריגס : טל ארצי : אנגלית
הטוחן המיילל : ארטו פאסילינה : רמי סערי : פינית
הטיגריס הלבן : ארווינד אדיגה : יואב כ"ץ : אנגלית
היהודי כמנודה   מסורת סמויה (כתבים יהודיים) : חנה ארנדט : None : עברית
היסטוריה של המדע לצעירים מכל הגילים : ויליאם ביינום : יפתח בריל : אנגלית
הירושימה : ג'ון הרסי : 	דנה אלעזר הלוי : אנגלית
המדריך הקצר לחיים ארוכים : דר דייוויד אגוס : גיא הרלינג : אנגלית
המוח הגברי : דר לואן בריזנדיין : יעל סלע-שפירו : אנגלית
המחברת האדומה : פול אוסטר : ברוריה בן ברוך : אנגלית
המחסל : חגי ליניק : None : עברית
המיטה שאתה מציע בעצמך : אילת שמיר : None : עברית
המיליון ששינה את המזרח התיכון העלייה הסובייטית לישראל (המיליון ששינה את המזרח התיכון) : לילי גלילי ורומן ברונפמן : None : עברית
הממלכה : אמיר אור : None : עברית
המנהיג והתקשורת : רפי מן : None : עברית
המסע המשותף : טלי אמסלם, צורית חפר ושי רפאלי : None : עברית
המעבר : ג'סטין קרונין : אינגה מיכאלי : אנגלית
המשפחה הראשונה : מייק דש : דבי אילון : אנגלית
הסיפור האמריקאי הקלאסי : אנתולוגיה : משה רון : אנגלית
הסוד המשותף : ז'ורז' סימנון : יהושע קנז : צרפתית
הנשמה  אינה נפחייה (מיסטר סקווישי) : דייוויד פוסטר וואלאס : אלינוער ברגר : אנגלית
הסיפור המופלא של הלן קלר : לורנה א. היקוק : נילי לוי : אנגלית
המערבולת : פיטר קוריס : שרונה גורי : אנגלית
המפקד האליון : יגיל לוי : None : עברית
המפתח שמתחת לאבן : בנג'מין בלאק : סמדר מילוא : אנגלית
המצב האנושי : חנה ארנדט : אריאלה אזולאי ועדי אופיר : אנגלית
המציאות הנסתרת : בריאן גרין : עמנואל לוטם : אנגלית
הנערה מבוסטון : אניטה דיאמנט : מרב זקס-פורטל : אנגלית
זיכרונות מהזונות העצובות שלי : גבריאל גרסיה מארקס : טל ניצן : ספרדית
זוגינומיקס איך לחשוב כמו כלכלנים ולשפר את חיי האהבה, הנישואים ושטיפת הכלים (זוגינומיקס ) : פולה שומאן וג'ני אנדרסון : None : עברית
זה לא מקום לילדות : הדר גת : None : עברית
זה הסוף שלך : ריאן נורת, מתיו בנארדו ודייוויד מלכי : יעל סלע-שפירו : אנגלית
וכשאני לעצמי מה אני : עמלה עינת : None : עברית
ויטו המעופף : זירלדו : יורם מלצר : פורטוגזית
וזהו זה! (איש שלא הבחין בשום דבר): רוברט ואלזר : רן הכהן : גרמנית
וולפי ואופי השטרודלים : צבי יגנדורף : יוסי מילוא : אנגלית
והיו הנעליים מאושרות : שושנה שרירא ואריאל כהן : None : עברית
ואז הבליח אור : אברם קנטור : None : עברית
ואז בדיוק התאהבתי בך" : שרי גל : None : עברית
ואדי מילח : אורנה עקאד : None : עברית
התריסר : ג'סטין קרונין : אינגה מיכאלי : אנגלית
השם הטוב : ג'ומפה להירי : שלומית אפל : אנגלית
הרשימה : יובל אברמוביץ' : None : עברית
הרציחות ברחוב מורְג (הרציחות ברחוב מורג) : אדגר אלן פו : שירלי אגוזי : אנגלית
הריצה של בינגו : ג'יימס א' לווין : עפרה אביגד : אנגלית
הקרקס הנסתר : ג'ניפר איגן : ברוריה בן ברוך : אנגלית
הקסום והנלהב (כל השירים) : ע. הלל : None : עברית
הפרשה המסתורית בסטיילס : אגתה כריסטי : מיכל אלפון : אנגלית
הפרה שבחדר : מלאני ג'וי : דבי אילון : אנגלית
הפילוסופים הגדולים (הפילוסופים הגדולים ) : סטיבן לאו : אינגה מיכאלי : אנגלית
העולם עד אתמול : ג'ארד דיימונד : עתליה זילבר : אנגלית
העולם בשנת 2050 : לורנס ס' סמית :  עפר קובר : אנגלית
הסכנות שבהתנהגות נלוזה : אונורה דה בלזק : מירי ליטבק : צרפתית
טִירְזָה (טירזה) : ארנון גרונברג : רחל ליברמן : הולנדית
זיכרונותיו של חבר דמיוני : מתיו דיקס : דנה אלעזר הלוי : אנגלית
זמן שאול (דברים שאני יודעת על ר') : אדוה בולה : None : עברית
חברות ששינו את העולם : ג'ונתן מנטל : עמית יריב : אנגלית
חברים, תופים ואקדח : דורית אורגד : None : עברית
חוב קטלני : ג'ון גאפר : דרורה בלישה : אנגלית
חוות החיות : ג'ורג' אורוול : לאה זגגי : אנגלית
חומצה גופריתנית : אמלי נותומב : חגית בת-עדה : צרפתית
חוקי מוסקבה : דניאל סילבה : ניצה פלד : אנגלית
חזק אותי : ג' קנר : מיכל רביד : אנגלית
חזקים ברוסיה : רן דברת : None : עברית
חיות הקודש : דר עידו חברוני : None : עברית
חיים כפולים : ס.ג'. ווטסון : אורלי מזור יובל : אנגלית
חירות : ג'ונתן פראנזן : עפרה אביגד : אנגלית
חלומותיהם החדשים : חיים באר : None : עברית
חמישה : יובל אלבשן : None : עברית
חצוצרה : ג'קי קיי : אלינוער ברגר : אנגלית
חצי חלון, חצי מראה : מוני אנדר : None : עברית
חרב הסרטן : הנק פרופר : רחל ליברמן : הולנדית
חרדה היא הזדמנות : עודד מבורך : None : עברית
חרפה : ג'. מ. קוטזי : סמדר מילוא : אנגלית
חשופה לעיניך : סילביה דיי : מיכל רביד : אנגלית
טהראן, רחוב המהפכה : אמיר חסן צ'הלתן : אורלי נוי : פרסית
טובת הילד : איאן מקיואן : מיכל אלפון : אנגלית
טיסת לילה : אדמת אנוש : משה מרון : אנגלית
לבחור באושר 101 דרכים להשיג את החיים שאנחנו רוצים (לבחור באושר) : ד"ר טל בן-שחר :None : עברית
ואז בדיוק התאהבתי בך : שרי גל : None : עברית
יומן חורף : פול אוסטר : אברהם יבין : אנגלית
יומן ספרותי : לאה גולדברג : None : עברית
יומני הערפד : ל. ג`. סמית : רחל אהרוני : אנגלית
כתם של עננה קלה : יואל אליצור : None : עברית
לא היה ולא נברא : דן בונה : None : עברית
יומני קרי : קנדיס בושנל : גיא הרלינג : אנגלית
יורחי הדבש : צ'אק קינדר : אמיר צוקרמן : אנגלית
ייעודו של דן : כרמית גלבוע : None : עברית
ילדה עם שיער מוזר מאת (ילדה עם שיער מוזר 1) : דיוויד פוסטר וואלאס : אלינוער ברגר ואסף גברון : אנגלית
ילדה עם שיער מוזר (ילדה עם שיער מוזר 2) : דיוויד פוסטר וואלאס : אלינוער ברגר ואסף גברון : אנגלית
ילדותו של ישו : ג'. מ. קוטזי : אברהם יבין : אנגלית
ים בחלון : לאה גולדברג : None : עברית
ימיה האחרונים של ראביט הייז : אנה מקפרטלין : רחל פן : אנגלית
יסתובב לו העולם הגדול : קולום מק`קאן : אמיר צוקרמן : אנגלית
יצחק רצח רבין  הסיפור שלא סופר (יצחק רצח רבין הסיפור שלא סופר) : דביר קריב : None : עברית
ירח כחול : אליסון נואל : נילי לוי : אנגלית
יש לך בשביל מה : אודי שרבני : None : עברית
כאב (דולפינים בקרית גת) : דנה חפץ : None : עברית
כבוד : אליף שאפיק : עידית שורר : אנגלית
כוס הקפה שגרמה לי להתאהב : פרופ תלמה ליבל : עופר קובר : אנגלית
כיסא הקשירה : קתרין הריסון : אלינוער ברגר : אנגלית
כל החיים לפניו : אמיל אז'אר : אביטל ענבר : צרפתית
כלה : אורה אחימאיר : None : עברית
כמעט מפורסמת 2 (כמעט מפורסמת 2- הכול יכול לקרות) : מיכל בכר : None : עברית
כן! : רוג'ר פישר, ויליאם יורי וברוס פאטון : דרורה בלישה : אנגלית
כפרה : איאן מקיואן : עתליה זילבר : אנגלית
כרוניקה של מחאה (רוטשילד - כרוניקה של מחאה) : אשר שכטר : None : עברית
כשדויד גרוסמן פגש את ויטו אקונצ`י : מרית בן ישראל : None : עברית
כשמכוניות נפלו מהשמים : צבי בראל : None : עברית
לואובוי : ג'ון ריי : גיא הרלינג : אנגלית
לוויתן : פול אוסטר : משה רון : אנגלית
לוותר או להסתער : סת' גודין : יעל סלע-שפירו : אנגלית
לחצות את קלנדיה : דניאלה נוריס ושירין ענבתאווי : None : עברית
לילה אחרון : אלדד גיל : אילנה ברנשטיין : אנגלית
לימסול : ישי שריד : None : עברית
לכל דבר יש מחיר מדוע אנחנו משלמים את מה שאנחנו משלמים (לכל דבר יש מחיר) : אדוארדו פורטר : דורון גרינשפן : אנגלית
ללא איפור : יצחק שילה : None : עברית
ללא גורל : אימרה קרטס : מרים אלגזי : הונגרית
ללמוד מהטובים ביותר : לאזלו בוק : ענבל שגיב נקדימון : אנגלית
למה הוא עושה את זה : לנדי בנקרופט : תמי אילון-אורטל : אנגלית
למעלה שקֵט (למעלה שקט) : חרברנד באקר : רחל ליברמן : הולנדית
לנצח : אליסון נואל : נילי לוי : אנגלית
לפרוץ קדימה : שריל סנדברג : עוםר קובר : אנגלית
לפתוח דלת (לפתוח דלת - לסגור עסקה) : לינדה ריצ'רדסון : דורון גרינשפן : אנגלית
מבחן המרשמלו מיומנות השליטה העצמית הבסיס להצלחה בחיים : וולטר מישל : גיא הרלינג  : אנגלית
מבחני הכוויה : ג'יימס דשנר : דבי אילון : אנגלית
לא זמן טוב לאהבה : יוסי יונה : None : עברית
לאה גולדברג (לאה גולדברג - ספר סרט מבחר שירים) : גדעון טיקוצקי : None : עברית
לבד בתיאטרון המוות : טרי הייז : שמעון בוזגלו : אנגלית
לגמרי במקרה : מעוז מוסל : None : עברית
לגעת בעושר איך להפוך מכשולים להזדמנויות! (לגעת בעושר) : שרון ל' לכטר וגרג ס' ריד : אסתי וכטל : אנגלית
לגרגר זפת : יאכים טופול : פאר פרידמן : צ'כית
להבה אפלה : אליסון נואל : נילי לוי : אנגלית
מלידה עד גיל שנה המדריך הישראלי לטיפול בתינוק : מור אסאל וענת בר לב : None : עברית
מלכודת כפולה : קארין גרהרדסן : יעל צובארי : שוודית
מנחם בשבת תרבות : מנחם המשעמם : None : עברית
מבעד לכוונות הטובות : שולי דיכטר : None : עברית
מבעד לכסות העור : אסתר כהן כרמל : None : עברית
מגידו : מתיו דן : שמעון בוזגלו : אנגלית
מגע הזהב : דונלד טראמפ ורוברט קיוסאקי : דרורה בלישה : אנגלית
מדריך רפרם לכלא הלובי : רפרם חדד : None : עברית
מדרכות (הפלדה החזקה ביותר) : עידן אלמוג : None : עברית
מה שהסתרתי בבטן : יונה טפר : None : עברית
מה שנשאר : אלי עמר : None : עברית
מובי דיק : הרמן מלוויל : גרשון גירון : אנגלית
מוסיקת המקרה : פול אוסטר : משה רון : אנגלית
מוסר ועסקים- הילכו שניהם יחדיו : אביבה גבע : None : עברית
מועדון המתאבדים : רוברט לואי סטיבנסון : אברהם יבין : אנגלית
מופע הזיקוקין של היקום : עמיר לוינסון : None : עברית
מורדים : ורוניקה רות : נילי לוי : אנגלית
מחוברת אליך השלישי בסדרת קרוספייר (מחוברת אליך) : סילביה דיי : מיכל רביד : אנגלית
מחסור : סנדהיל מולנייתן ואלדר שפיר : אמנון כץ : אנגלית
מטרה לילית : ריקרדו פיגליה : ליה נירגד : ספרדית
מי אני מה אני מסע פילוסופי מרתק אל תוך עצמנו (מי אני מה אני) : ריכרד דוויד פרכט : אלעד לפידות : גרמנית
מי בכלל דיבר על אהבה : אורית רז : None : עברית
מיועדים : אליסון נואל : יעל סלע-שפירו : אנגלית
מיסטר סקווישי (מיסטר סקווישי 2) : דייויד פוסטר וואלאס : אלינוער ברגר : עברית
מכונת השקר : גרשון בן-שחר ומריאנה בר : None : עברית
מכירת חיסול : יו לורי : יעל אכמון : אנגלית
מכתוב : איריס אליה-כהן : None : עברית
מלאכים באופק : מרב זקס : None : עברית
מלחמת התשוקה : ג'ון גריי : מיכל רביד : אנגלית
נקמת דם בפריז : סטיב ברי : אמנון כץ : אנגלית
נתתי לך ללכת : קלייר מקינטוש : אסנת הדר : אנגלית
מסות ומאמרים : אברהם שלונסקי : None : עברית
מסעות בנימין השלישי : מנדלה מוכר ספרים : None : עברית
מעבר לקצה : סי־ג'יי בוקס : יוני רז פורטוגלי : אנגלית
מעריסה לעריסה  Cradle to Cradle (מעריסה לעריסה) : מיכאל בראונגרט וויליאם מק'דונו : אור אלכסנדרוביץ' : אנגלית
מפגש עם חוליית הבריונים : ג'ניפר איגן : יואב כ"ץ : אנגלית
מפוצלים : ורוניקה רוֹת : נילי לוי : אנגלית
מפורסם : גואל פינטו : None : עברית
מפריח היונים : אלי עמר : None : עברית
מפתח גאודי : אסטבן מרטין ואנדראו קראנסה : איתי רון : ספרדית
מקוללים : ג'וזפין אנג'ליני : יעל ענבר : אנגלית
מקום יפה למות בו : מאלה נאן : לאה ששקו : אנגלית
מקומות אפלים : גיליאן פלין : יעל אכמון : אנגלית
מקמאפיה (מקמאפיה-פשע ללא גבולות) : מישה גלני : דפנה לוי : אנגלית
מר פוטר : ג'מייקה קינקייד : יערית טאובר בן-יעקב : אנגלית
מרגלי הבלקן : אלן פירסט : צילה אלעזר : אנגלית
מרתון : זהר פרידמן : None : עברית
משא האשמה : זיו דורקם : None : עברית
משה לנדוי, שופט (משה לנדוי - שופט) : מיכל שקד : None : עברית
משהו כיפי לכאורה שלא אחזור עליו לעולם : דיוויד פוסטר וואלאס : אלינוער ברגר : אנגלית
משחקים ושעשועי שווא : ג'יימס סולטר : יונתן דה שליט : אנגלית
משתקפת בך : סילביה דיי : מיכל רביד : אנגלית
נאמנים : ורוניקה רות : מיכל בכר : אנגלית
נגד האלים : פיטר ברנשטיין : שיר חבר : אנגלית
נואה נואה מסע לטהיטי : פול גוגן : ארזה טיר-אפלרויט : צרפתית
נמכרה : פטרישיה מק'קורמיק : רז קטלן : אנגלית
נסיבות טבעיות : ג'יימס אוסוולד : אורית הראל : אנגלית
נעליים (מטאטא וסיפורים אחרים) : לאוניד פקרובסקי : טניה חזנובסקי ותומר שריג : רוסית
נעלמת : ג`יליאן פלין : יעל אכמון : אנגלית
נער החידות ממומביי : ויקאס סווארופ : סיגל אדלר : אנגלית
פה גדול איינשטיין : אלון שילדקראוט : None : עברית
פור : ורוניקה רות : נילי לוי : אנגלית
סהרורים : ג'וזפין אנג'ליני : יעל ענבר : אנגלית
סוד האהבה : כנרת טל מאיר : None : עברית
סוד הקסם היפני : מארי קונדו : אורית בן זאב : אנגלית
סודות אל. איי : ג'יימס אלרוי : אודי תגרי : אנגלית
סוויטות לצ'לו : אריק סיבלין : סמדר מילוא : אנגלית
סוכן במלכוד : דניאל סילבה : ניצה פלד : אנגלית
סוכן זיגזג : בן מקנטייר : דפנה בן יוסף : אנגלית
סטיאגרהה בדרום אפריקה : מ' ק' גנדהי : מתן קמינר : אנגלית
סטפני מאייר (שחר מפציע) : סטפני מאייר : רחל אהרוני : אנגלית
סיימון מוצא את דרכו : בקי אלברטלי : כנרת היגינס-דוידי : אנגלית
סילנד : נגה אלבלך : None : עברית
סיפורי ניק אדמס : ארנסט המינגוויי : יואב כ"ץ : אנגלית
ספינות של קרבה : רווה שגיא : None : עברית
ספינת העבדים  היסטוריה אנושית (ספינת העבדים) : מרקוס רדיקר : עפרה אביגד : אנגלית
ספר האש : ג'יין בורודייל : יניב פרקש : אנגלית
ספר האשליות : פול אוסטר : ברוריה בן ברוך : אנגלית
ספר הלחישות : ורוז`אן ווסגניאן : אנני שילון : רומנית
ספרד : אנטוניו מוניוס מולינה : פרידה פרס-דניאלי : ספרדית
עד אין קץ : אליסון נואל : נילי לוי : אנגלית
עוד מעט החורף מתחיל : שי אספריל : None : עברית
עולם ומלואו סיפורם של כדור הארץ ובני האדם מהמפץ הגדול ועד ימינו (עולם ומלואו - סיפורם של כדור הארץ ובני האדם מהמפץ הגדול ועד ימינו) : כריסטופר לויד : גיא הרלינג : אנגלית
עולם חדש מופלא : אלדוס האקסלי : מאיר ויזלטיר : אנגלית
על פני הבריאה כולה : רות ל. אוזקי : שרון גל : אנגלית
על שתי רגליים וכנפיים : עבאס קזורני : יעל סלע-שפירו : אנגלית
עסקים מחוץ לקופסה : ג'ייסון פריד ודייוויד ה' הנסון : גרשון גירון : אנגלית
עץ הדודא : חנה בת שחר : None : עברית
עץ עשן : דניס ג'ונסון : ליה נירגד : אנגלית
פָּאדְרֶה פָּדְרוֹנֶה — אבי, אדוני (פאדרה פדרונה אבי, אדוני) : גווינו לדה : מירון רפופורט : איטלקית
פוֹרטוּן (פורטון) : רונה אלקולומברי-דז'ובס : None : עברית
פורצת הדרך מעג'מי : נאדיה חילו : None : עברית
פחות זה הרבה יותר : ליאו בבאוטה : מוטי הינוך : אנגלית
פרבולה של הצלחה : ליאוניד פקרובסקי : טניה חזנובסקי ותומר שריג : רוסית
פתרון סופי : מייקל שייבון : אלינוער ברגר : אנגלית
צדק למראית עין : דר מייקל באדן ולינדה קני באדן : שרה ריפין : אנגלית
ציידי הראשים : יו נסבו : דנה כספי : נורווגית
ציפור אלוהים שבשמיים (ציפור אלוהים שבשמים): ג'יימס מקברייד : צילה אלעזר : אנגלית
צל עולם : ניר ברעם : None : עברית
קבר הקיסר : סטיב ברי : אמנון כץ : אנגלית
קו המלח (שני כרכים) : יובל שמעוני : None : עברית
קולד מאונטן : צ'רלס פרייזר : ליה נירגד : אנגלית
קין : ז'וז'ה סאראמאגו : מרים טבעון : פורטוגזית
קיץ ללא גברים : סירי הוסטוט : מיכל כהן : אנגלית
קרב אותי : ג' קנר : מיכל רביד : אנגלית
קרקע לא מוכרת : ג'ומפה להירי : מיכל אלפון : אנגלית
ראיונות קצרים עם גברים נתעבים : דיוויד פוסטר וואלאס : אלינוער ברגר : אנגלית
רוחות מלחמה גרעינית : אורי שטנדל : None : עברית
רומן וינאי : דוד פוגל : None : עברית
רונאלדו (רונאלדו - השאיפה לשלמות) : לוקה קאיולי : יונתן פיין : אנגלית
רציחות נוסח אוקספורד  : גיירמו מרטינז : עינת טלמון : ספרדית
רצפת חול : אורית גרוס : None : עברית
רק שלא יגיד את המילה הזאת : יעל נאמן ברק : None : עברית
רשת אפלה : מישה גלני : דפנה לוי : אנגלית
שבת : איאן מקיואן : סמדר מילוא : אנגלית
שושה : יצחק בשביס זינגר : צבי ארד : יידיש
שחרר אותי : ג' קנר : מיכל רביד : אנגלית
שמש חדשה : שי טובלי ואילון לסטר : None : עברית
שנים עשר השבטים של האטי : איאנה מאתיס : מיכל אלפון : אנגלית
שנת הארנב : ארטו פאסילינה : רמי סערי : פינית
שנת הבשרים שלי : רות ל. אוזקי : אלינוער ברגר : אנגלית
שרון, חייו של מנהיג : גלעד שרון : None : עברית
תיק קצב : יובל יועז : None : עברית
תיק רצח : טוני פרסונס : יואב כ"ץ : אנגלית
תרופת המוות : ג'יימס דשנר : דבי אילון : אנגלית
תרנגול כפרות : אלי עמיר : None : עברית
תשרין : איימן סיכסק : None : עברית